urlHelp=help/index.html
lastSaved=Последнее сохранение
currentFile=Текущий файл
toolbar=Инструменты
save=Сохранить
print=Печать
cut=Вырезать
copy=Копировать
paste=Вставить
delete=Удалить
undo=Назад
redo=Вперед
select=Выбрать
connect=Соединение
pan=Панель
zoomIn=Приблизить
zoomOut=Отдалить
zoom=Масштаб
fit=По размеру
actualSize=Действительный
selectAll=Выбрать всё
clearSelection=Убрать выбор
shape=Фигура
format=Формат
font=Шрифт
group=Группировать
ungroup=Разгруппировать
removeFromParent=Удалить из родителя
align=Выравнивание
left=Лево
right=Право
center=Центр
top=Верх
middle=Середина
bottom=Низ
collapse=Свернуть
expand=Развернуть
toBack=На задний план
toFront=На передний план
enterGroup=Добавить в группу
exitGroup=Убрать из группы
layout=Разметка
horizontalTree=Горизонтальное дерево
verticalTree=Вертикальное дерево
fillColor=Цвет заливки
strokeColor=Цвет контура
gradientColor=Градиент
bold=Жирный
italic=Курсив
fontColor=Цвет шрифта
fontSize=Размер шрифта
fontFamily=Семейство шрифтов
examples=Примеры
newDiagram=Новая диаграмма
image=Изображение
opacity=Прозрачность
selection=Выбор
editStyle=Изменить стиль
enterStyle=Введите стиль
enterColorname=Введите цвет
enterImageUrl=Введите URL изображения
enterOpacity=Введите прозрачность (%)
enterFontsize=Введите размер шрифта (pt)
enterFontfamily=Введите семейство шрифтов
toggleRounded=Закругленный
toggleShadow=Тень
toggleOrientation=Ориентация
openHref=Открыть URL
show=Показать
posterPrint=Печать
saveXML=Сохранить
exportXML=Экспорт в XML
exportSvgPng=Экспорт в SVG/PNG
changesLost=Все изменения будут утеряны!
swimlanes=Swimlanes
travelBooking=Travel Booking
notAvailable=Недоступно